友	friend
学	study
試	attempt
験	exam
争	battle
静	quiet
予	beforehand
野	field
嫌	hate
物	thing
高	tall
直	straightaway
値	price
段	step
聞	listen
遊	play
待	wait
猫	cat
要	need
免	exemption
勉	try hard
路	road
街	town
語	language
登	climb
録	record
家	house
部	section
至	until
屋	store
